1111111111111
1001C000000C1
1CP0011111001
100011E00C001
1111111111111