1111111111111111111111111111111111
1E00N0000000000C00000C0N000P000001
10100101001000001010010000N0010101
101001N010101010001001000000010101
100000000C00C000000N000000000000C1
1111111111111111111111111111111111