1111111111111
10010000000C1
1P0N011111001
100000E000001
1111111111111