1111111111111111111111111111111111
1E00N0000000000C00000C0N0000000001
1N100101001000001010010000N0010101
101001N010101010001001000000010101
1P0000000C00C000000N000000000000C1
1111111111111111111111111111111111