11111111111111111111111111111111
10PCE000000C00010000010000000001
101N010100100N001010010000000101
10100100101010100010010000001101
1000000000000000N000000000000001
11111111111111111111111111111111